It is the Rising Epoch of Spells. A time of great discovery and powerful magic. But something terribly bad is about to happen.

Jewel Craft, Ivy Veil and the Amulet of Power
An Interactive Fiction by Wesley Werner
Release 1 / Serial number 161011 / Inform 7 build 6M62 (I6/v6.33 lib 6/12N) SD

Your friend Rain Arcana bursts through your door: "Ivy! We need your help!"
"What is going on, Rain?"
"Burnspring the Sorcerous trapped the magician's guild in a powerful spell, the city is powerless against him!" he pants.
"My help? I make jewelry, how in the name of Anerat can I help?", you feel uneasy.
Rain steadies himself, "Our magicians are trapped, to be sure, and I fear I will be taken soon."
Rain holds out an amulet for you to take.

Your Home
A cosy place.

You can see an Amulet and a wooden door here.

>go out
(first opening the wooden door)
Best you take the amulet with you.

>go out
(first opening the wooden door)
Best you take the amulet with you.

>look
Your Home
A cosy place.

You can see an Amulet and a wooden door here.

>take amulet
The amulet feels solid and reassuring in your palms. "What is this?"
Rain leans in, "The Amulet of Power. It will help us defeat Burnspring, you need to find the four missing stones, and return in time to save us all, Ivy."
You feel dread, but reassured by the magical token. "How do I find these stones?"
"Go find the Riddler on the Hill, the amulet will guide you from there.", he sighs.

>go out
(first opening the wooden door)

Hill Path
There is shrubbery and trees around you. You can hear water flowing, but cannot see much through the dense foliage. Town is due south, you have no need to go back there right now.

>x door
You can't see any such thing.

>look
Hill Path
Town is due south, you have no need to go back there right now.

>go in\
You can't see any such thing.

>go in
You can't go that way.

>go out
You can't go that way.

>s
You can't go that way.

* * *

>take amulet
The amulet is seamless, like crafted from magic, it feels solid and reassuring in your palms. "What is this?"
Rain leans in, "The Amulet of Power. It will help us defeat Burnspring, you need to find the four missing stones, and return in time to save us all, Ivy."
You feel dread, but reassured by the magical token. "How do I find these stones?"
"Go find the Riddler on the Hill, the amulet will guide you from there.", he sighs.

>use amulet
I didn't understand that sentence.

>use amulet for protection
You feel protected from evil curses.

>x amulet
Your amulet has an Amethyst for Protection, an Emerald for Insight, Obsidian for Strength and Amber for Healing. You can use amulet.

>use amulet
I didn't understand that sentence.

* * *

>use amulet for protection
You feel protected from evil curses.

>x protection
You can't see any such thing.

>showme amulet
Amulet - thing
location: carried by yourself in Your Home
singular-named, improper-named; unlit, inedible, portable, handled
list grouping key: none
printed name: "Amulet"
printed plural name: none
indefinite article: none
description: "Your amulet has an Amethyst for Protection, an Emerald for Insight, Obsidian for Strength and Amber for Healing. You can use amulet."
initial appearance: none
level: 4
time left: 20
ability: protection

* * *

>take amulet
The amulet is seamless, like crafted from magic, it feels solid and reassuring in your palms. "What is this?"
Rain leans in, "The Amulet of Power. It will help us defeat Burnspring, you need to find the four missing stones, and return in time to save us all, Ivy."
You feel dread, but reassured by the magical token. "How do I find these stones?"
"Go find the Riddler on the Hill, the amulet will guide you from there.", he sighs.

>showme amulet
Amulet - thing
location: carried by yourself in Your Home
singular-named, improper-named; unlit, inedible, portable, handled
list grouping key: none
printed name: "Amulet"
printed plural name: none
indefinite article: none
description: "Your amulet has an Amethyst for Protection, an Emerald for Insight, Obsidian for Strength and Amber for Healing. You can use amulet."
initial appearance: none
level: 4
time left: 0
ability: none

>use amulet for protection
You feel protected from evil curses.

>showme amulet
Amulet - thing
location: carried by yourself in Your Home
singular-named, improper-named; unlit, inedible, portable, handled
list grouping key: none
printed name: "Amulet"
printed plural name: none
indefinite article: none
description: "Your amulet has an Amethyst for Protection, an Emerald for Insight, Obsidian for Strength and Amber for Healing. You can use amulet."
initial appearance: none
level: 4
time left: 6
ability: protection

>wait
Time passes.

You feel your protection fading.

>showme amulet
Amulet - thing
location: carried by yourself in Your Home
singular-named, improper-named; unlit, inedible, portable, handled
list grouping key: none
printed name: "Amulet"
printed plural name: none
indefinite article: none
description: "Your amulet has an Amethyst for Protection, an Emerald for Insight, Obsidian for Strength and Amber for Healing. You can use amulet."
initial appearance: none
level: 4
time left: 5
ability: protection

>wait
Time passes.

>wait
Time passes.

>wait
Time passes.

Your protection has worn off.

* * *

>take amulet
The amulet is seamless, like crafted from magic, it feels solid and reassuring in your palms. "What is this?"
Rain leans in, "The Amulet of Power. It will help us defeat Burnspring, you need to find the four missing stones, and return in time to save us all, Ivy."
You feel dread, but reassured by the magical token. "How do I find these stones?"
"Go find the Riddler on the Hill, the amulet will guide you from there.", he sighs.

>use amulet for protection
You feel protected from evil curses.

>use amulet for insight
Your ability of protection is now removed.

Your intuition heightens.

>use amulet for protection
Your ability of insight is now removed.

You feel protected from evil curses.

>use amulet for insight
Your ability of protection is now removed.

Your intuition heightens.

>use amulet for strength
Your ability of insight is now removed.

You feel strength coursing through your body.

>use amulet for healing
Your ability of strength is now removed.

You are enveloped by a healing aura.

>x amulet
You have the Amethyst stone, the Emerald stone, the Obsidian stone and the Amber stone.
You can use the amulet for Protection, Insight, Strength or Healing.

>use the amulet for insight
Your ability of healing is now removed.

Your intuition heightens.

>use the amulet for protection
Your ability of insight is now removed.

You feel protected from evil curses.

* * *

>take amulet
The amulet is seamless, like crafted from magic, it feels solid and reassuring in your palms. "What is this?"
Rain leans in, "The Amulet of Power. It will help us defeat Burnspring, you need to find the four missing stones, and return in time to save us all, Ivy."
You feel dread, but reassured by the magical token. "How do I find these stones?"
"Go find the Riddler on the Hill, the amulet will guide you from there.", he sighs.

>x amulet
There are four empty slots to hold four stones.

>give stone
You can't see any such thing.

>x amulet
There are four empty slots to hold four stones.